Name: grassy_plain
TAGS: sprint no_item_gen no_trap_gen no_rotate no_hmirror no_vmirror
DESC: A Grassy Plain
ORDER: 10
ORIENT: encompass
FTILE: g = floor_grass
FTILE: d = floor_dirt
MAP
xxxxxxxxxxxxxxxxxxxxxxxxxxxxxxxxxxxxxxxxxxxxxxxxxxxxxxxxxx
xxxxxxxxxxxxxxxxxxxxxxxxxxxxxxxxcccccccccccccccccccccccccx
xccccccccccccccccccccccccccccccxtttttttttttttgggggggggggcx
xcggggggggggggggggggggggggggggcxttgttttggttttgggggggggggcx
xcggggtgggggggggggggtgggggggggcxttttgttttttttgggggggggggcx
xcggggggggggggggggddddddddddddddddddddddddddddddddddddddcx
xcgggggggTggggggggggggggggggggcxtttttttttttttccccccccccccx
xcggggggggggggggggggggggggggggcxtttttttttttttxxxxxxxxxxxxx
xcggggg{gggggggggggcccc+ccccggcxccccccccccccc
xcgggggggggggggggggc.......cggcxxxxxxxxxxxxxx
xcggggggtggggggggggc.......cggcx
xcgggggggggggggggggc.......cggcx
xcgggggggggggggggggc.......cggcx
xcggggggggggtggggggcccccccccggcx
xcggggggggggggggggggggggggggggcx
xccccccccccccccccccccccccccccccx
xxxxxxxxxxxxxxxxxxxxxxxxxxxxxxxx
ENDMAP